         Проверяющий                         Проверяемый

Азимов          Манучехр       <->	Шакшак          Омар           
Баров           Дмитрий        <->	Борейко         Артем          
Борейко         Артем          <->	Джало           Лаиза          
Буйволов        Евгений        <->	Кирушев         Михаил         
Данилкина       Юлия           <->	Липатов         Герман         
Джало           Лаиза          <->	Орехова         Алина          
Долбня          Владимир       <->	Сечко           Ксения         
Евсин           Роман          <->	Исаева          Елизавета      
Исаева          Елизавета      <->	Баров           Дмитрий        
Кирушев         Михаил         <->	Лапина          Елена          
Краморев        Андрей         <->	Могилина        Виктория       
Лапина          Елена          <->	Данилкина       Юлия           
Липатов         Герман         <->	Евсин           Роман          
Мареныч         Александр      <->	Сазанова        Алена          
Могилина        Виктория       <->	Краморев        Андрей         
Орехова         Алина          <->	Азимов          Манучехр       
Поддорогина     Евгения        <->	Буйволов        Евгений        
Сазанова        Алена          <->	Мареныч         Александр      
Сечко           Ксения         <->	Поддорогина     Евгения        
Шакшак          Омар           <->	Долбня          Владимир       
